QLHua

Hello World!

Hi, QLHua!

AAAAAAAAAAAAAAAAAAAAAA
BBBBBBBBBBBBBBBBBBBBBB
CCCCCCCCCCCCCCCCCCCCCC
eeeeeeeeeeeeeeeeeeeeee
ffffffffffffffffffffff
HHHHHHHHHHHHHHHHHHHHHH
ZZZZZZZZZZZZZZZZZZZZZZ
be quiet!
1111111111111111111111
2222222222222222222222
3333333333333333333333

